111111111111111111111111111111111111111
100000000100001000000000000000001000011
100000000100001000011111000000001000011
100000000100001000000001000010001000001
111110000000000000000000000000001000011
100000000000000P00000001000010001000001
100000000000000000000001000000001000011
101111111110000000000001000010000000001
100000000000000000000000000000000000001
100000000000000000000000000000000000001
100000000000000000000000000000000000001
100001111111110000000000000000000000001
100000000001111111110000000000000000001
100000000000000000000000000000000000001
100000000000000000000000000000000000001
111111111111111111111111111111111111111